
 ### ### # ### #
 # # #   # # # #
 ### # # # ### #
     # # #     #
 ##### # # #####
       #
 # ### # ### ###
 #       # # # #
 # ### # ### ###
       #
 ##### # # #####
     # # #     #
 ### # # # ### #
 # # #   # # # #
 ### ### # ### #
